++++++++++++++++++++++++++++++++++++++++++++++++++++++++++++++++++++++++++++++++++++++++++++++++++++
====================================================================================================
====================================================================================================
====================================================================================================
====================================================================================================
----------------------------------------------------------------------------------------------------
----------------------------------------------------------------------------------------------------
----------------------------------------------------------------------------------------------------
::::::::::::::::::::::::::::::::::::::::::::::::::::::::::::::::::::::::::::::::::::::::::::::::::::
::::::::::::::::::::::::::::::::::::::::::::::::::::::::::::::::::::::::::::::::::::::::::::::::::::
::::::::::::::::::::::::.....:::...............:::::::::::::::::::::::::::::::::::::::::::::::::::::
::::::::............................................................................................
....................................................................................................
....................................................................................................
....................................................................................................
................................................::::-----==+++=-:...................................
:::................:::::::......::::::::::--=+++++*****##%%%#%####*=:...............................
--------------:::::::::::::::::::--::::--=+++++++*****%%%###%#%###***=--::::::::::::::.........:....
-------------::::::::::::::-:--=====+++++===-=+*#######%%####%#####%###+-:::::::::::::::::::::::::::
-=====--==------------------*###%%############%%@@%@%%%%%%%%%%%%%%%%%%%%=::::-:::-::::::::::::::::::
------::--:::::::::::::::::=%@@@@@@@@@%%%%%%%%%@@%%#@%%%%%%%%%%%%%%@%%%%-:::::::::..................
---------------------::::::-#@@@@@@@@%%%%%%%@@%#%%##@%%%@@@@@@@@@@@@@#%+:::::::::::::::::::::.......
--------------------------+***#@@@@@@@@@@@@@@@@####%@%%%###***+++====--:::::::::::::::::::::::::::::
-----------------------------===+++++++++++++++===-----:::::::::::::::::::::::::::::::::::::::::::::
------------------------------::::::::::::::::::::::::::::::::::::::::::::::::::::::::::::::::::::::
--------------------------::::::::::::::::::::::::::::::::::::::::::::::::::::::::::::::::::::::::::
---------------------::::::---::::::::::::::::::::::::::::::::::::::::::::::::::::::::::::::::::::::
---------:::::::::::::::::::::::::-:::::::::::::::::::::::::::::::::::::::::::::::::::::::::::::::::
:::::::::::::::::::::---------------------:::::::::::::::::::::::::---------------::::---:::-:::----
:::::::::-------------------------------------------------------------------------------------------
----------------------------------------------------------------------------------------------------
----------------------------------------------------------------------------------------------------
----------------------------------------------------------------------------------------------------
----------------------------------------------------------------------------------------------------
----------------------------------------------------------------------------------------------------
