++++++++++++++++++++++++++++++++++++++++++++++++++++++++++++++++++++++++++++++++
================================================================================
================================================================================
================================================================================
--------------------------------------------------------------------------------
--------------------------------------------------------------------------------
-----------:::::::::::::::::::::::::::::::::::::::::::::::::::::::--------------
::::::::::::::::::::::::::::::::::::::::::::::::::::::::::::::::::::::::::::::::
:::::::::::::::::.......................::::::::::::::::::::::::::::::::::::::::
..:::...........................................................................
................................................................................
................................................................................
.....................................:::---===++*++=:...........................
::::::::::::::::::::::::::::::::-==++++****#%%#%%%####=:.........:::::..........
----------:::::::::::::-------===---=++***##%%#########*+=::::::::::::::::::::::
--==---=--------------=*#############%%@@%#%%%%%%%%%%%%%%*::::::::::::::::::::::
-----::-::::::::::::::#@@@@@@%%%%%%%%%@%%%%%%%%%%%%%%%@%%*::::::::..............
----------------::::--+#%@@@@@%%%%%@@%#%#%@@@@@@@@%%%##**-:::::::::::::::::::...
---------------------++**######%%%####*++++===---:::::::::::::::::::::::::::::::
---------------------------:::::::::::::::::::::::::::::::::::::::::::::::::::::
---------------------:::::::::::::::::::::::::::::::::::::::::::::::::::::::::::
------------::::::::::::::::::::::::::::::::::::::::::::::::::::::::::::::::::::
-:::::::::::::::::::::----------:::::::::::::::::::::::::::::---:-:::--:::::::--
:::::::::-----------------------------------------------------------------------
--------------------------------------------------------------------------------
--------------------------------------------------------------------------------
--------------------------------------------------------------------------------
--------------------------------------------------------------------------------
