@@@@@@@@@@@@@@@@@@@@%%%@%%#%%#######%%%%%%@@@%%%%@@%%%%%%%%%%%%%%%%%%%%%%@@@@@%@
@@@@@@@@@@@@@@@@@@@@@@%@%%%#%%%%%%%#%%%%%%%@@@@%@@@%%%%%%%%%%%%%%%%%%%@@@@@@@@@@
#%@@@@@@@@@@@@@@@@@@@%%%%%%%%%%%%%#%%%%%%%%@@@%##%%%%%%%@%%%%%%%%%%%%%@@@@@@@@@@
@%@@@@@@@@@@@@@@@@@@@@@@@@@@@@%%%%%%%@%%%%%@@@%%%%%%%%%%%%%%%%%##%%%%%@@@@@@@@@@
@@@@@@@@@@@@@@%%%%%%%%%%%%%%%%%%%%%%%##**++++=======++++%%%##=----=%%%%@@@@@@@@@
@@@@@@@@@@@@%=.....:..:--::::::-==-----..............:*%%@@@@+---::*%%@@@@@@@@@@
@@@@@@@@@@@#:......::-====----%%#==+=:......::-:::---#@@@@@%@@%=::#@%@#%@@@@@@@@
@@@@@@@@@@@+-----*%%+-====----****++==-:..:--%@%#+===*@@@@@%@@@%-:%@%@@@@@@@@@@@
@@@@@@@@@@@+---+@@@@+------:+%#%%%@@@@%-----*@@@@@%@@@@@@@@%#@@#:.+%%%%@@@@@@@@@
@@@@@@@@@@@*---=%@@*=----:::*%@@@@@@@@*---===@@@@@@@@@@@@@@@+*%%##*+%%%%@@@@@@@@
@@@@@@@@@@@#----=++==---:-*%%@@@@@@@@@=--=---+%@@@@@@@#@@@@@#+#@%%%%%%%@@@@@@@@@
@@@@@@@%@@@#---===++=---=%@@@@@@@@@@#=--------==*%@@@*+*%@@@#%@%%@@@@@@@@@@@@@@@
%%%@@@@@@@@+---==+++----*@@@@@@@@@@@+===-------==+++==++++++#%%%%%%%%%%%%%%%@@%@
%%%@@@@@%%#---==+++**+=-=%@@@@@@@@@#+=====-----========++==**********+******##*#
%@%%%%@@%%=---==+*##+====+***#####*+******+=----=+=====+==++++++++++++++++++++++
##********=---=+++**++++++++**********++++++=--==+*+++++++++++++++++++++++++++++
****++++++===-=++-+******++=====++==-------=##===-=+++=====--=---==========-====
+=========--==++-+*=--==--====----------::--+#===--=+=-=--:--:-:--==+====-==-:-:
=========---=++==+==-=----===-------=---::-::=*%=::-+++---------------=--=======
=------------=+-==--:--:---:-:--=--=----===---=+----==-----==--+===---=====++=++
===-==-=----==*=+=--::--:------====*===-=====-=-----=-------=====----=-===+***+*
====++==--=+=++*#**++-==--===-----=====-:---====-==----=-==---=-==-=+======+=+=+
+++==-=-=====++=+=-==---------=---==----==-----=----------------=--------=--===-
====-======---=-===--==--==---------------------------:---=-==------============
-=--===-====-=-======-----==------=--------::--::-=-==-=-:------===+=+==========
====-========--=--====-====------==-==-----------=====-==========+==+=====+=====
